1111111111111111111
10000000000000CPCE1
10000000000000CCCC1
1000000000000000001
1000000000000000001
1000000000000000001
1000C00000000000001
1000000000000000001
1000000000000000011
1000000000000000001
1000000000000000001
1111111111111111111
