111111111111111111111111111111
1E0000000000000C10000C00000001
100001010010000110100100010101
101001001010101000100100010101
10CCC0000C01C0000000000000CCC1
101001010010100010100100010101
101001001010101000100100010101
10CCC0000C00C0000000000000CCC1
101001010010000011001000101001
10100100101010100P100100010101
10CCC0000C00C0000000000000CCC1
101001010010000010100100010101
101001001010101000100100001011
10CCC0000C00C00000000000000CC1
111111111111111111111111111111